{
	"name": "cabeza",
	"cant_pixeles_por_baldosa": 50,
	"centros" : [
      {
         "pos_x" : 1,
         "pos_y" : 9
      },
      {
         "pos_x" : 8,
         "pos_y" : 14
      },
      {
         "pos_x" : 1,
         "pos_y" : 1
      }
   	],
	"terreno": [
[30,31,32,33,34,35,36,30,30,30,30,30,30,32,32,32,32,32,32,32,30,30,30,30],
[30,30,30,30,30,30,30,30,30,30,30,30,30,32,32,32,32,32,32,32,30,30,30,30],
[30,30,30,30,30,30,30,30,30,30,30,30,30,32,32,32,32,32,32,32,30,30,30,30],
[35,35,35,35,35,35,30,30,30,30,30,30,30,32,32,32,32,32,32,32,30,30,30,30],
[0,0,0,0,0,0,0,0,35,31,31,30,30,30,30,30,30,30,30,30,30,30,30,30],
[0,0,0,0,0,0,0,0,35,31,31,30,30,30,30,30,30,30,30,30,30,30,30,30],
[0,0,0,0,0,0,0,0,34,31,31,30,30,30,30,30,30,30,30,30,30,30,30,30],
[0,0,0,0,0,0,0,0,34,31,31,30,30,30,30,30,30,30,30,30,30,30,30,30],
[0,0,0,0,0,0,0,0,34,31,31,30,30,30,30,30,30,30,30,30,30,30,30,30],
[0,0,0,0,0,0,0,0,34,31,31,30,30,30,30,30,30,30,30,30,30,30,30,30],
[0,0,0,0,0,0,0,0,34,31,31,30,30,30,30,30,30,30,30,30,30,30,30,30],
[0,0,0,0,0,0,0,0,32,31,31,30,30,30,30,30,30,30,30,30,30,30,30,30],
[35,35,35,35,34,34,30,30,30,30,30,30,30,30,30,30,30,30,30,30,30,30,30,30],
[30,30,30,30,30,30,30,30,30,30,30,30,30,30,30,30,30,30,30,30,30,30,30,30],
[30,30,30,30,30,30,30,30,30,30,30,30,30,30,30,30,30,30,30,30,30,30,30,30],
[30,30,30,30,30,30,30,30,30,30,30,30,30,30,30,30,30,30,30,30,30,30,30,30],
[30,30,30,30,30,30,30,30,30,30,30,30,30,30,30,30,30,30,30,30,30,30,30,30],
[30,30,30,30,30,30,30,30,30,30,30,30,30,30,30,30,30,30,30,30,30,30,30,30],
[30,30,30,30,30,30,30,30,30,30,30,30,30,30,30,30,30,30,30,30,30,30,30,30],
[30,30,30,30,30,30,30,30,30,30,30,30,30,30,30,30,30,30,30,30,30,30,30,30],
[30,30,30,30,30,30,30,30,30,30,30,30,30,30,30,30,30,30,30,30,30,30,30,30],
[30,30,30,30,30,30,30,30,30,30,30,30,30,30,30,30,30,30,30,30,30,30,30,30],
[30,30,30,30,30,30,30,30,30,30,30,30,30,30,30,30,30,30,30,30,30,30,30,30],
[30,30,30,30,30,30,30,30,30,30,30,30,30,30,30,30,30,30,30,30,30,30,30,30],
[30,30,30,30,30,30,30,30,30,30,30,30,30,30,30,30,30,30,30,30,30,30,30,30],
[30,30,30,30,30,30,30,30,30,30,30,30,30,30,30,30,30,30,30,30,30,30,30,30],
[30,30,30,30,30,30,30,30,30,30,30,30,30,30,30,30,30,30,30,30,30,30,30,30],
[30,30,30,30,30,30,30,30,30,30,30,30,30,30,30,30,30,30,30,30,30,30,30,30],
[30,30,30,30,30,30,30,30,30,30,30,30,30,30,30,30,30,30,30,30,30,30,30,30],
[30,30,30,30,30,30,30,30,30,30,30,30,30,30,30,30,30,30,30,30,30,30,30,30],
[30,30,30,30,30,30,30,30,30,30,30,30,30,30,30,30,30,30,30,30,30,30,30,30],
[30,30,30,30,30,30,30,30,30,30,30,30,30,30,30,30,30,30,30,30,30,30,30,30],
[30,30,30,30,30,30,30,30,30,30,30,30,30,30,30,30,30,30,30,30,30,30,30,30],
[30,30,30,30,30,30,30,30,30,30,30,30,30,30,30,30,30,30,30,30,30,30,30,30]
           ]
}